WrapperSubsetEval(KStar)-PSOSearch	LOST_METS_IN_5_UTR,CONSERVED_METS_NO_STOP_IN_5_UTR,CDS_COORDS,MET_POSITION,READING_FRAME_STATUS,PREMATURE_STOP_CODON,STOP_CODON_POSITION,CLASS,
WrapperSubsetEval(KStar)-BestFirst	NMETS_5_UTR,CONSERVED_METS_NO_STOP_IN_5_UTR,CDS_COORDS,MET_POSITION,READING_FRAME_STATUS,STOP_CODON_POSITION,CLASS,
WrapperSubsetEval(KStar)-MultiObjectiveEvolutionarySearch	LOST_METS_IN_5_UTR,CONSERVED_METS_NO_STOP_IN_5_UTR,CDS_COORDS,MET_POSITION,READING_FRAME_STATUS,STOP_CODON_POSITION,CLASS,
CfsSubsetEval-GreedyStepwise	NMETS_5_UTR,CONSERVED_METS_IN_5_UTR,CODON_CHANGE,MET_POSITION,MUTATED_SEQUENCE_LENGTH,CLASS,
WrapperSubsetEval(LibSVM)-GreedyStepwise	CONSERVED_METS_NO_STOP_IN_5_UTR,MET_POSITION,MUTATED_SEQUENCE_LENGTH,CLASS,
WrapperSubsetEval(PART)-PSOSearch	NMETS_5_UTR,MET_POSITION,NO_STOP_CODON,CLASS,
WrapperSubsetEval(BayesNet)-GreedyStepwise	NMETS_5_UTR,LOST_METS_IN_5_UTR,CDS_COORDS,AMINOACID_CHANGE,READING_FRAME_STATUS,PREMATURE_STOP_CODON,CLASS,
WrapperSubsetEval(J48)-BestFirst	NMETS_5_UTR,READING_FRAME_STATUS,MUTATED_SEQUENCE_LENGTH,CLASS,
WrapperSubsetEval(BayesNet)-MultiObjectiveEvolutionarySearch	NMETS_5_UTR,CODON_CHANGE,READING_FRAME_STATUS,PREMATURE_STOP_CODON,MUTATED_SEQUENCE_LENGTH,CLASS,
WrapperSubsetEval(BayesNet)-BestFirst	NMETS_5_UTR,LOST_METS_IN_5_UTR,CDS_COORDS,AMINOACID_CHANGE,READING_FRAME_STATUS,PREMATURE_STOP_CODON,CLASS,
CfsSubsetEval-MultiObjectiveEvolutionarySearch	NMETS_5_UTR,CONSERVED_METS_IN_5_UTR,CODON_CHANGE,MET_POSITION,MUTATED_SEQUENCE_LENGTH,CLASS,
WrapperSubsetEval(J48)-PSOSearch	CONSERVED_METS_NO_STOP_IN_5_UTR,AMINOACID_CHANGE,CODON_CHANGE,MET_POSITION,CLASS,
WrapperSubsetEval(BayesNet)-PSOSearch	NMETS_5_UTR,CDS_COORDS,CODON_CHANGE,READING_FRAME_STATUS,PREMATURE_STOP_CODON,CLASS,
CfsSubsetEval-PSOSearch	NMETS_5_UTR,CONSERVED_METS_IN_5_UTR,AMINOACID_CHANGE,MET_POSITION,MUTATED_SEQUENCE_LENGTH,CLASS,
WrapperSubsetEval(LibSVM)-PSOSearch	CONSERVED_METS_NO_STOP_IN_5_UTR,MET_POSITION,MUTATED_SEQUENCE_LENGTH,CLASS,
WrapperSubsetEval(J48)-GreedyStepwise	NMETS_5_UTR,READING_FRAME_STATUS,MUTATED_SEQUENCE_LENGTH,CLASS,
WrapperSubsetEval(LibSVM)-MultiObjectiveEvolutionarySearch	CONSERVED_METS_NO_STOP_IN_5_UTR,MET_POSITION,MUTATED_SEQUENCE_LENGTH,CLASS,
CfsSubsetEval-BestFirst	NMETS_5_UTR,CONSERVED_METS_IN_5_UTR,CODON_CHANGE,MET_POSITION,MUTATED_SEQUENCE_LENGTH,CLASS,
WrapperSubsetEval(PART)-GreedyStepwise	NMETS_5_UTR,MET_POSITION,CLASS,
WrapperSubsetEval(KStar)-GreedyStepwise	NMETS_5_UTR,CDS_COORDS,MET_POSITION,STOP_CODON_POSITION,CLASS,
WrapperSubsetEval(LibSVM)-BestFirst	CONSERVED_METS_NO_STOP_IN_5_UTR,MET_POSITION,MUTATED_SEQUENCE_LENGTH,CLASS,
WrapperSubsetEval(PART)-MultiObjectiveEvolutionarySearch	NMETS_5_UTR,MET_POSITION,CLASS,
WrapperSubsetEval(PART)-BestFirst	NMETS_5_UTR,MET_POSITION,CLASS,
WrapperSubsetEval(J48)-MultiObjectiveEvolutionarySearch	NMETS_5_UTR,READING_FRAME_STATUS,MUTATED_SEQUENCE_LENGTH,CLASS,
